"filename", "language", "Dart", "JSON", "comment", "blank", "total"
"/Users/yahyajawad/Desktop/Contents/Flutter/baghdad_fair/lib/core/components/blocObserver.dart", "Dart", 0, 0, 28, 5, 33
"/Users/yahyajawad/Desktop/Contents/Flutter/baghdad_fair/lib/core/components/constrainedSliverToBoxAdapter.dart", "Dart", 17, 0, 0, 1, 18
"/Users/yahyajawad/Desktop/Contents/Flutter/baghdad_fair/lib/core/components/constrainedSliverWidth.dart", "Dart", 21, 0, 0, 3, 24
"/Users/yahyajawad/Desktop/Contents/Flutter/baghdad_fair/lib/core/components/customCachedImage.dart", "Dart", 20, 0, 0, 2, 22
"/Users/yahyajawad/Desktop/Contents/Flutter/baghdad_fair/lib/core/components/customEmptyWidget.dart", "Dart", 20, 0, 0, 2, 22
"/Users/yahyajawad/Desktop/Contents/Flutter/baghdad_fair/lib/core/components/customErrorWidget.dart", "Dart", 20, 0, 0, 1, 21
"/Users/yahyajawad/Desktop/Contents/Flutter/baghdad_fair/lib/core/components/customFilterButton.dart", "Dart", 32, 0, 0, 1, 33
"/Users/yahyajawad/Desktop/Contents/Flutter/baghdad_fair/lib/core/components/customLoadingIndicator.dart", "Dart", 13, 0, 0, 2, 15
"/Users/yahyajawad/Desktop/Contents/Flutter/baghdad_fair/lib/core/components/customLoadingWidget.dart", "Dart", 16, 0, 0, 1, 17
"/Users/yahyajawad/Desktop/Contents/Flutter/baghdad_fair/lib/core/components/customSearchBar.dart", "Dart", 54, 0, 0, 2, 56
"/Users/yahyajawad/Desktop/Contents/Flutter/baghdad_fair/lib/core/components/customTextField.dart", "Dart", 32, 0, 0, 1, 33
"/Users/yahyajawad/Desktop/Contents/Flutter/baghdad_fair/lib/core/components/custumButton.dart", "Dart", 29, 0, 0, 1, 30
"/Users/yahyajawad/Desktop/Contents/Flutter/baghdad_fair/lib/core/components/sectionTitle.dart", "Dart", 39, 0, 0, 2, 41
"/Users/yahyajawad/Desktop/Contents/Flutter/baghdad_fair/lib/core/components/sectionTitleButton.dart", "Dart", 38, 0, 0, 1, 39
"/Users/yahyajawad/Desktop/Contents/Flutter/baghdad_fair/lib/core/components/youtubeButton.dart", "Dart", 28, 0, 0, 4, 32
"/Users/yahyajawad/Desktop/Contents/Flutter/baghdad_fair/lib/core/errors/failures.dart", "Dart", 45, 0, 0, 5, 50
"/Users/yahyajawad/Desktop/Contents/Flutter/baghdad_fair/lib/core/utilities/apiService.dart", "Dart", 26, 0, 0, 2, 28
"/Users/yahyajawad/Desktop/Contents/Flutter/baghdad_fair/lib/core/utilities/appAssets.dart", "Dart", 29, 0, 0, 0, 29
"/Users/yahyajawad/Desktop/Contents/Flutter/baghdad_fair/lib/core/utilities/appCache.dart", "Dart", 26, 0, 0, 6, 32
"/Users/yahyajawad/Desktop/Contents/Flutter/baghdad_fair/lib/core/utilities/appRouter.dart", "Dart", 150, 0, 0, 4, 154
"/Users/yahyajawad/Desktop/Contents/Flutter/baghdad_fair/lib/core/utilities/appStyles.dart", "Dart", 113, 0, 0, 7, 120
"/Users/yahyajawad/Desktop/Contents/Flutter/baghdad_fair/lib/core/utilities/constants.dart", "Dart", 8, 0, 0, 3, 11
"/Users/yahyajawad/Desktop/Contents/Flutter/baghdad_fair/lib/core/utilities/pagesFilters.dart", "Dart", 7, 0, 0, 0, 7
"/Users/yahyajawad/Desktop/Contents/Flutter/baghdad_fair/lib/core/utilities/pagesPagination.dart", "Dart", 109, 0, 0, 8, 117
"/Users/yahyajawad/Desktop/Contents/Flutter/baghdad_fair/lib/core/utilities/providers.dart", "Dart", 47, 0, 1, 2, 50
"/Users/yahyajawad/Desktop/Contents/Flutter/baghdad_fair/lib/core/utilities/serviceLocator.dart", "Dart", 47, 0, 0, 3, 50
"/Users/yahyajawad/Desktop/Contents/Flutter/baghdad_fair/lib/core/utilities/urlLauncher.dart", "Dart", 9, 0, 0, 1, 10
"/Users/yahyajawad/Desktop/Contents/Flutter/baghdad_fair/lib/features/home/data/models/navBarModel.dart", "Dart", 89, 0, 4, 4, 97
"/Users/yahyajawad/Desktop/Contents/Flutter/baghdad_fair/lib/features/home/presentation/managers/language/languageCubit.dart", "Dart", 24, 0, 2, 4, 30
"/Users/yahyajawad/Desktop/Contents/Flutter/baghdad_fair/lib/features/home/presentation/managers/language/languageStates.dart", "Dart", 5, 0, 0, 3, 8
"/Users/yahyajawad/Desktop/Contents/Flutter/baghdad_fair/lib/features/home/presentation/views/homeView.dart", "Dart", 15, 0, 0, 2, 17
"/Users/yahyajawad/Desktop/Contents/Flutter/baghdad_fair/lib/features/home/presentation/views/widgets/homeAppBar.dart", "Dart", 100, 0, 0, 8, 108
"/Users/yahyajawad/Desktop/Contents/Flutter/baghdad_fair/lib/features/home/presentation/views/widgets/homeAppBarImage.dart", "Dart", 30, 0, 1, 4, 35
"/Users/yahyajawad/Desktop/Contents/Flutter/baghdad_fair/lib/features/home/presentation/views/widgets/homeNavBar.dart", "Dart", 97, 0, 0, 7, 104
"/Users/yahyajawad/Desktop/Contents/Flutter/baghdad_fair/lib/features/home/presentation/views/widgets/homeViewBody.dart", "Dart", 60, 0, 6, 8, 74
"/Users/yahyajawad/Desktop/Contents/Flutter/baghdad_fair/lib/features/home/presentation/views/widgets/languageDropdownButton.dart", "Dart", 44, 0, 0, 7, 51
"/Users/yahyajawad/Desktop/Contents/Flutter/baghdad_fair/lib/features/homeBody/aboutUs/data/models/aboutUsModel.dart", "Dart", 32, 0, 0, 14, 46
"/Users/yahyajawad/Desktop/Contents/Flutter/baghdad_fair/lib/features/homeBody/aboutUs/data/repository/aboutUsRepo.dart", "Dart", 6, 0, 0, 1, 7
"/Users/yahyajawad/Desktop/Contents/Flutter/baghdad_fair/lib/features/homeBody/aboutUs/data/repository/aboutUsRepoImpl.dart", "Dart", 23, 0, 0, 2, 25
"/Users/yahyajawad/Desktop/Contents/Flutter/baghdad_fair/lib/features/homeBody/aboutUs/presentation/manager/aboutUs/aboutUsBloc.dart", "Dart", 22, 0, 0, 1, 23
"/Users/yahyajawad/Desktop/Contents/Flutter/baghdad_fair/lib/features/homeBody/aboutUs/presentation/manager/aboutUs/aboutUsEvents.dart", "Dart", 2, 0, 0, 0, 2
"/Users/yahyajawad/Desktop/Contents/Flutter/baghdad_fair/lib/features/homeBody/aboutUs/presentation/manager/aboutUs/aboutUsStates.dart", "Dart", 12, 0, 0, 2, 14
"/Users/yahyajawad/Desktop/Contents/Flutter/baghdad_fair/lib/features/homeBody/aboutUs/presentation/views/aboutUsBody.dart", "Dart", 52, 0, 0, 4, 56
"/Users/yahyajawad/Desktop/Contents/Flutter/baghdad_fair/lib/features/homeBody/aboutUs/presentation/views/components/aboutUsContext.dart", "Dart", 47, 0, 0, 3, 50
"/Users/yahyajawad/Desktop/Contents/Flutter/baghdad_fair/lib/features/homeBody/ads/data/models/adsModel.dart", "Dart", 39, 0, 0, 12, 51
"/Users/yahyajawad/Desktop/Contents/Flutter/baghdad_fair/lib/features/homeBody/ads/data/repository/adsRepo.dart", "Dart", 9, 0, 0, 1, 10
"/Users/yahyajawad/Desktop/Contents/Flutter/baghdad_fair/lib/features/homeBody/ads/data/repository/adsRepoImpl.dart", "Dart", 26, 0, 0, 1, 27
"/Users/yahyajawad/Desktop/Contents/Flutter/baghdad_fair/lib/features/homeBody/ads/presentation/manager/ads/adsBloc.dart", "Dart", 23, 0, 0, 1, 24
"/Users/yahyajawad/Desktop/Contents/Flutter/baghdad_fair/lib/features/homeBody/ads/presentation/manager/ads/adsEvents.dart", "Dart", 7, 0, 0, 0, 7
"/Users/yahyajawad/Desktop/Contents/Flutter/baghdad_fair/lib/features/homeBody/ads/presentation/manager/ads/adsStates.dart", "Dart", 13, 0, 0, 3, 16
"/Users/yahyajawad/Desktop/Contents/Flutter/baghdad_fair/lib/features/homeBody/ads/presentation/views/adsBody.dart", "Dart", 29, 0, 0, 2, 31
"/Users/yahyajawad/Desktop/Contents/Flutter/baghdad_fair/lib/features/homeBody/ads/presentation/views/components/adsItem.dart", "Dart", 73, 0, 0, 1, 74
"/Users/yahyajawad/Desktop/Contents/Flutter/baghdad_fair/lib/features/homeBody/ads/presentation/views/components/adsList.dart", "Dart", 78, 0, 0, 5, 83
"/Users/yahyajawad/Desktop/Contents/Flutter/baghdad_fair/lib/features/homeBody/companiesGuide/data/models/companiesGuideModel.dart", "Dart", 58, 0, 0, 12, 70
"/Users/yahyajawad/Desktop/Contents/Flutter/baghdad_fair/lib/features/homeBody/companiesGuide/data/repository/coGuideRepo.dart", "Dart", 9, 0, 0, 1, 10
"/Users/yahyajawad/Desktop/Contents/Flutter/baghdad_fair/lib/features/homeBody/companiesGuide/data/repository/coGuideRepoImpl.dart", "Dart", 26, 0, 0, 1, 27
"/Users/yahyajawad/Desktop/Contents/Flutter/baghdad_fair/lib/features/homeBody/companiesGuide/presentation/manager/companiesGuide/coGuideBloc.dart", "Dart", 26, 0, 0, 1, 27
"/Users/yahyajawad/Desktop/Contents/Flutter/baghdad_fair/lib/features/homeBody/companiesGuide/presentation/manager/companiesGuide/coGuideEvents.dart", "Dart", 7, 0, 0, 1, 8
"/Users/yahyajawad/Desktop/Contents/Flutter/baghdad_fair/lib/features/homeBody/companiesGuide/presentation/manager/companiesGuide/coGuideStates.dart", "Dart", 13, 0, 0, 3, 16
"/Users/yahyajawad/Desktop/Contents/Flutter/baghdad_fair/lib/features/homeBody/companiesGuide/presentation/manager/filters/coGuideFiltersBloc.dart", "Dart", 42, 0, 0, 4, 46
"/Users/yahyajawad/Desktop/Contents/Flutter/baghdad_fair/lib/features/homeBody/companiesGuide/presentation/manager/filters/coGuideFiltersEvents.dart", "Dart", 5, 0, 0, 3, 8
"/Users/yahyajawad/Desktop/Contents/Flutter/baghdad_fair/lib/features/homeBody/companiesGuide/presentation/manager/filters/coGuideFiltersStates.dart", "Dart", 3, 0, 0, 4, 7
"/Users/yahyajawad/Desktop/Contents/Flutter/baghdad_fair/lib/features/homeBody/companiesGuide/presentation/views/companiesGuideBody.dart", "Dart", 15, 0, 0, 2, 17
"/Users/yahyajawad/Desktop/Contents/Flutter/baghdad_fair/lib/features/homeBody/companiesGuide/presentation/views/components/coGuideAboutItem.dart", "Dart", 22, 0, 0, 1, 23
"/Users/yahyajawad/Desktop/Contents/Flutter/baghdad_fair/lib/features/homeBody/companiesGuide/presentation/views/components/coGuideItem.dart", "Dart", 156, 0, 14, 3, 173
"/Users/yahyajawad/Desktop/Contents/Flutter/baghdad_fair/lib/features/homeBody/companiesGuide/presentation/views/components/coGuideList.dart", "Dart", 86, 0, 0, 5, 91
"/Users/yahyajawad/Desktop/Contents/Flutter/baghdad_fair/lib/features/homeBody/companiesGuide/presentation/views/components/sectionTitleAndFilter/coGuideCompleteSectionTitle.dart", "Dart", 20, 0, 0, 3, 23
"/Users/yahyajawad/Desktop/Contents/Flutter/baghdad_fair/lib/features/homeBody/companiesGuide/presentation/views/components/sectionTitleAndFilter/coGuideSearchAndFiltering.dart", "Dart", 158, 0, 0, 4, 162
"/Users/yahyajawad/Desktop/Contents/Flutter/baghdad_fair/lib/features/homeBody/companiesGuide/presentation/views/components/sectionTitleAndFilter/coGuideSectionTitle.dart", "Dart", 14, 0, 0, 4, 18
"/Users/yahyajawad/Desktop/Contents/Flutter/baghdad_fair/lib/features/homeBody/companiesGuide/presentation/views/components/sectionTitleAndFilter/dropdowns/coGuideActivityDropDownButton.dart", "Dart", 144, 0, 1, 10, 155
"/Users/yahyajawad/Desktop/Contents/Flutter/baghdad_fair/lib/features/homeBody/companiesGuide/presentation/views/components/sectionTitleAndFilter/dropdowns/coGuideSectionDropdownButton.dart", "Dart", 122, 0, 1, 7, 130
"/Users/yahyajawad/Desktop/Contents/Flutter/baghdad_fair/lib/features/homeBody/companiesGuide/presentation/views/components/sectionTitleAndFilter/dropdowns/coGuideTypeDropdownButton.dart", "Dart", 144, 0, 1, 8, 153
"/Users/yahyajawad/Desktop/Contents/Flutter/baghdad_fair/lib/features/homeBody/fairs/data/models/fairsModel.dart", "Dart", 55, 0, 0, 12, 67
"/Users/yahyajawad/Desktop/Contents/Flutter/baghdad_fair/lib/features/homeBody/fairs/data/repository/fairsRepo.dart", "Dart", 9, 0, 0, 1, 10
"/Users/yahyajawad/Desktop/Contents/Flutter/baghdad_fair/lib/features/homeBody/fairs/data/repository/fairsRepoImpl.dart", "Dart", 26, 0, 0, 2, 28
"/Users/yahyajawad/Desktop/Contents/Flutter/baghdad_fair/lib/features/homeBody/fairs/presentation/manager/fairs/fairsBloc.dart", "Dart", 26, 0, 0, 1, 27
"/Users/yahyajawad/Desktop/Contents/Flutter/baghdad_fair/lib/features/homeBody/fairs/presentation/manager/fairs/fairsEvents.dart", "Dart", 7, 0, 0, 1, 8
"/Users/yahyajawad/Desktop/Contents/Flutter/baghdad_fair/lib/features/homeBody/fairs/presentation/manager/fairs/fairsStates.dart", "Dart", 13, 0, 0, 2, 15
"/Users/yahyajawad/Desktop/Contents/Flutter/baghdad_fair/lib/features/homeBody/fairs/presentation/manager/filters/fairsFiltersBloc.dart", "Dart", 42, 0, 0, 5, 47
"/Users/yahyajawad/Desktop/Contents/Flutter/baghdad_fair/lib/features/homeBody/fairs/presentation/manager/filters/fairsFiltersEvents.dart", "Dart", 5, 0, 0, 3, 8
"/Users/yahyajawad/Desktop/Contents/Flutter/baghdad_fair/lib/features/homeBody/fairs/presentation/manager/filters/fairsFiltersStates.dart", "Dart", 3, 0, 0, 4, 7
"/Users/yahyajawad/Desktop/Contents/Flutter/baghdad_fair/lib/features/homeBody/fairs/presentation/views/components/fairsAboutItem.dart", "Dart", 22, 0, 0, 1, 23
"/Users/yahyajawad/Desktop/Contents/Flutter/baghdad_fair/lib/features/homeBody/fairs/presentation/views/components/fairsItem.dart", "Dart", 172, 0, 1, 4, 177
"/Users/yahyajawad/Desktop/Contents/Flutter/baghdad_fair/lib/features/homeBody/fairs/presentation/views/components/fairsList.dart", "Dart", 91, 0, 0, 5, 96
"/Users/yahyajawad/Desktop/Contents/Flutter/baghdad_fair/lib/features/homeBody/fairs/presentation/views/components/sectionTitleAndFilter/dropdowns/fairsConditionDropDownButton.dart", "Dart", 143, 0, 1, 12, 156
"/Users/yahyajawad/Desktop/Contents/Flutter/baghdad_fair/lib/features/homeBody/fairs/presentation/views/components/sectionTitleAndFilter/dropdowns/fairsLocationsDropdownButton.dart", "Dart", 142, 0, 1, 8, 151
"/Users/yahyajawad/Desktop/Contents/Flutter/baghdad_fair/lib/features/homeBody/fairs/presentation/views/components/sectionTitleAndFilter/dropdowns/fairsSectionDropdownButton.dart", "Dart", 124, 0, 0, 7, 131
"/Users/yahyajawad/Desktop/Contents/Flutter/baghdad_fair/lib/features/homeBody/fairs/presentation/views/components/sectionTitleAndFilter/fairsCompleteSectionTitle.dart", "Dart", 20, 0, 0, 3, 23
"/Users/yahyajawad/Desktop/Contents/Flutter/baghdad_fair/lib/features/homeBody/fairs/presentation/views/components/sectionTitleAndFilter/fairsSearchAndFiltering.dart", "Dart", 158, 0, 0, 3, 161
"/Users/yahyajawad/Desktop/Contents/Flutter/baghdad_fair/lib/features/homeBody/fairs/presentation/views/components/sectionTitleAndFilter/fairsSectionTitle.dart", "Dart", 14, 0, 0, 4, 18
"/Users/yahyajawad/Desktop/Contents/Flutter/baghdad_fair/lib/features/homeBody/fairs/presentation/views/fairsBody.dart", "Dart", 16, 0, 0, 2, 18
"/Users/yahyajawad/Desktop/Contents/Flutter/baghdad_fair/lib/features/homeBody/home/data/models/homeModel.dart", "Dart", 61, 0, 0, 12, 73
"/Users/yahyajawad/Desktop/Contents/Flutter/baghdad_fair/lib/features/homeBody/home/data/models/mapsModels.dart", "Dart", 27, 0, 0, 1, 28
"/Users/yahyajawad/Desktop/Contents/Flutter/baghdad_fair/lib/features/homeBody/home/data/repository/homeRepo.dart", "Dart", 7, 0, 0, 1, 8
"/Users/yahyajawad/Desktop/Contents/Flutter/baghdad_fair/lib/features/homeBody/home/data/repository/homeRepoImpl.dart", "Dart", 28, 0, 1, 4, 33
"/Users/yahyajawad/Desktop/Contents/Flutter/baghdad_fair/lib/features/homeBody/home/presentation/manager/home/homeBloc.dart", "Dart", 19, 0, 0, 1, 20
"/Users/yahyajawad/Desktop/Contents/Flutter/baghdad_fair/lib/features/homeBody/home/presentation/manager/home/homeEvents.dart", "Dart", 2, 0, 0, 1, 3
"/Users/yahyajawad/Desktop/Contents/Flutter/baghdad_fair/lib/features/homeBody/home/presentation/manager/home/homeStates.dart", "Dart", 12, 0, 0, 2, 14
"/Users/yahyajawad/Desktop/Contents/Flutter/baghdad_fair/lib/features/homeBody/home/presentation/views/components/mainContactUs.dart", "Dart", 113, 0, 1, 3, 117
"/Users/yahyajawad/Desktop/Contents/Flutter/baghdad_fair/lib/features/homeBody/home/presentation/views/components/mainContactUsItem.dart", "Dart", 38, 0, 0, 1, 39
"/Users/yahyajawad/Desktop/Contents/Flutter/baghdad_fair/lib/features/homeBody/home/presentation/views/components/mainDetails.dart", "Dart", 43, 0, 0, 2, 45
"/Users/yahyajawad/Desktop/Contents/Flutter/baghdad_fair/lib/features/homeBody/home/presentation/views/components/mainHomeInfo.dart", "Dart", 53, 0, 0, 1, 54
"/Users/yahyajawad/Desktop/Contents/Flutter/baghdad_fair/lib/features/homeBody/home/presentation/views/components/mainHomeInfoItem.dart", "Dart", 45, 0, 0, 1, 46
"/Users/yahyajawad/Desktop/Contents/Flutter/baghdad_fair/lib/features/homeBody/home/presentation/views/components/mainLinks.dart", "Dart", 97, 0, 0, 3, 100
"/Users/yahyajawad/Desktop/Contents/Flutter/baghdad_fair/lib/features/homeBody/home/presentation/views/components/mainMaps.dart", "Dart", 44, 0, 0, 2, 46
"/Users/yahyajawad/Desktop/Contents/Flutter/baghdad_fair/lib/features/homeBody/home/presentation/views/components/mainShowTimeInfo.dart", "Dart", 56, 0, 0, 2, 58
"/Users/yahyajawad/Desktop/Contents/Flutter/baghdad_fair/lib/features/homeBody/home/presentation/views/components/mapButton.dart", "Dart", 38, 0, 0, 1, 39
"/Users/yahyajawad/Desktop/Contents/Flutter/baghdad_fair/lib/features/homeBody/home/presentation/views/mainHomeBody.dart", "Dart", 74, 0, 0, 5, 79
"/Users/yahyajawad/Desktop/Contents/Flutter/baghdad_fair/lib/features/homeBody/news/data/models/newsModel.dart", "Dart", 52, 0, 0, 12, 64
"/Users/yahyajawad/Desktop/Contents/Flutter/baghdad_fair/lib/features/homeBody/news/data/repository/newsRepo.dart", "Dart", 9, 0, 0, 1, 10
"/Users/yahyajawad/Desktop/Contents/Flutter/baghdad_fair/lib/features/homeBody/news/data/repository/newsRepoImpl.dart", "Dart", 26, 0, 0, 2, 28
"/Users/yahyajawad/Desktop/Contents/Flutter/baghdad_fair/lib/features/homeBody/news/presentation/manager/news/newsBloc.dart", "Dart", 26, 0, 0, 1, 27
"/Users/yahyajawad/Desktop/Contents/Flutter/baghdad_fair/lib/features/homeBody/news/presentation/manager/news/newsEvents.dart", "Dart", 7, 0, 0, 1, 8
"/Users/yahyajawad/Desktop/Contents/Flutter/baghdad_fair/lib/features/homeBody/news/presentation/manager/news/newsStates.dart", "Dart", 13, 0, 0, 2, 15
"/Users/yahyajawad/Desktop/Contents/Flutter/baghdad_fair/lib/features/homeBody/news/presentation/views/components/calendarFilter.dart", "Dart", 132, 0, 3, 7, 142
"/Users/yahyajawad/Desktop/Contents/Flutter/baghdad_fair/lib/features/homeBody/news/presentation/views/components/newsCard.dart", "Dart", 74, 0, 1, 1, 76
"/Users/yahyajawad/Desktop/Contents/Flutter/baghdad_fair/lib/features/homeBody/news/presentation/views/components/newsCardsList.dart", "Dart", 78, 0, 0, 4, 82
"/Users/yahyajawad/Desktop/Contents/Flutter/baghdad_fair/lib/features/homeBody/news/presentation/views/components/newsSectionTitle.dart", "Dart", 48, 0, 0, 4, 52
"/Users/yahyajawad/Desktop/Contents/Flutter/baghdad_fair/lib/features/homeBody/news/presentation/views/newsBody.dart", "Dart", 27, 0, 0, 2, 29
"/Users/yahyajawad/Desktop/Contents/Flutter/baghdad_fair/lib/features/homeBody/participatingCompanies/data/models/companiesModel.dart", "Dart", 61, 0, 0, 12, 73
"/Users/yahyajawad/Desktop/Contents/Flutter/baghdad_fair/lib/features/homeBody/participatingCompanies/data/repository/companiesRepo.dart", "Dart", 9, 0, 0, 1, 10
"/Users/yahyajawad/Desktop/Contents/Flutter/baghdad_fair/lib/features/homeBody/participatingCompanies/data/repository/companiesRepoImpl.dart", "Dart", 26, 0, 0, 2, 28
"/Users/yahyajawad/Desktop/Contents/Flutter/baghdad_fair/lib/features/homeBody/participatingCompanies/presentation/manager/companies/companiesBloc.dart", "Dart", 26, 0, 0, 1, 27
"/Users/yahyajawad/Desktop/Contents/Flutter/baghdad_fair/lib/features/homeBody/participatingCompanies/presentation/manager/companies/companiesEvents.dart", "Dart", 7, 0, 0, 1, 8
"/Users/yahyajawad/Desktop/Contents/Flutter/baghdad_fair/lib/features/homeBody/participatingCompanies/presentation/manager/companies/companiesStates.dart", "Dart", 13, 0, 0, 2, 15
"/Users/yahyajawad/Desktop/Contents/Flutter/baghdad_fair/lib/features/homeBody/participatingCompanies/presentation/views/components/participatingCompaniesItem.dart", "Dart", 81, 0, 0, 1, 82
"/Users/yahyajawad/Desktop/Contents/Flutter/baghdad_fair/lib/features/homeBody/participatingCompanies/presentation/views/components/participatingCompaniesItemSingleSection.dart", "Dart", 82, 0, 0, 1, 83
"/Users/yahyajawad/Desktop/Contents/Flutter/baghdad_fair/lib/features/homeBody/participatingCompanies/presentation/views/components/participatingCompaniesList.dart", "Dart", 82, 0, 0, 4, 86
"/Users/yahyajawad/Desktop/Contents/Flutter/baghdad_fair/lib/features/homeBody/participatingCompanies/presentation/views/participatingCompaniesBody.dart", "Dart", 30, 0, 0, 2, 32
"/Users/yahyajawad/Desktop/Contents/Flutter/baghdad_fair/lib/features/homeBody/participatingCountries/data/models/countriesModel.dart", "Dart", 38, 0, 0, 12, 50
"/Users/yahyajawad/Desktop/Contents/Flutter/baghdad_fair/lib/features/homeBody/participatingCountries/data/repository/countriesRepo.dart", "Dart", 8, 0, 0, 1, 9
"/Users/yahyajawad/Desktop/Contents/Flutter/baghdad_fair/lib/features/homeBody/participatingCountries/data/repository/countriesRepoImpl.dart", "Dart", 25, 0, 0, 1, 26
"/Users/yahyajawad/Desktop/Contents/Flutter/baghdad_fair/lib/features/homeBody/participatingCountries/presentation/manager/countries/countriesBloc.dart", "Dart", 19, 0, 0, 1, 20
"/Users/yahyajawad/Desktop/Contents/Flutter/baghdad_fair/lib/features/homeBody/participatingCountries/presentation/manager/countries/countriesEvents.dart", "Dart", 5, 0, 0, 1, 6
"/Users/yahyajawad/Desktop/Contents/Flutter/baghdad_fair/lib/features/homeBody/participatingCountries/presentation/manager/countries/countriesStates.dart", "Dart", 12, 0, 0, 2, 14
"/Users/yahyajawad/Desktop/Contents/Flutter/baghdad_fair/lib/features/homeBody/participatingCountries/presentation/views/components/countriesGrid.dart", "Dart", 56, 0, 0, 4, 60
"/Users/yahyajawad/Desktop/Contents/Flutter/baghdad_fair/lib/features/homeBody/participatingCountries/presentation/views/components/countriesItem.dart", "Dart", 36, 0, 0, 2, 38
"/Users/yahyajawad/Desktop/Contents/Flutter/baghdad_fair/lib/features/homeBody/participatingCountries/presentation/views/participatingCountriesBody.dart", "Dart", 27, 0, 0, 2, 29
"/Users/yahyajawad/Desktop/Contents/Flutter/baghdad_fair/lib/features/homeBody/sponsoringCompanies/data/models/sponsoringModel.dart", "Dart", 39, 0, 0, 11, 50
"/Users/yahyajawad/Desktop/Contents/Flutter/baghdad_fair/lib/features/homeBody/sponsoringCompanies/data/repository/sponsoringRepo.dart", "Dart", 6, 0, 0, 1, 7
"/Users/yahyajawad/Desktop/Contents/Flutter/baghdad_fair/lib/features/homeBody/sponsoringCompanies/data/repository/sponsoringRepoImpl.dart", "Dart", 23, 0, 0, 2, 25
"/Users/yahyajawad/Desktop/Contents/Flutter/baghdad_fair/lib/features/homeBody/sponsoringCompanies/presentation/manager/sponsors/sponsorsBloc.dart", "Dart", 19, 0, 0, 1, 20
"/Users/yahyajawad/Desktop/Contents/Flutter/baghdad_fair/lib/features/homeBody/sponsoringCompanies/presentation/manager/sponsors/sponsorsEvents.dart", "Dart", 2, 0, 0, 1, 3
"/Users/yahyajawad/Desktop/Contents/Flutter/baghdad_fair/lib/features/homeBody/sponsoringCompanies/presentation/manager/sponsors/sponsorsStates.dart", "Dart", 12, 0, 0, 2, 14
"/Users/yahyajawad/Desktop/Contents/Flutter/baghdad_fair/lib/features/homeBody/sponsoringCompanies/presentation/views/components/diamondPartners.dart", "Dart", 70, 0, 0, 4, 74
"/Users/yahyajawad/Desktop/Contents/Flutter/baghdad_fair/lib/features/homeBody/sponsoringCompanies/presentation/views/components/goldenPartners.dart", "Dart", 71, 0, 0, 4, 75
"/Users/yahyajawad/Desktop/Contents/Flutter/baghdad_fair/lib/features/homeBody/sponsoringCompanies/presentation/views/components/polygonClipper.dart", "Dart", 26, 0, 0, 7, 33
"/Users/yahyajawad/Desktop/Contents/Flutter/baghdad_fair/lib/features/homeBody/sponsoringCompanies/presentation/views/components/polygonItem.dart", "Dart", 39, 0, 0, 1, 40
"/Users/yahyajawad/Desktop/Contents/Flutter/baghdad_fair/lib/features/homeBody/sponsoringCompanies/presentation/views/components/silverPartners.dart", "Dart", 70, 0, 0, 4, 74
"/Users/yahyajawad/Desktop/Contents/Flutter/baghdad_fair/lib/features/homeBody/sponsoringCompanies/presentation/views/sponsoringCompaniesBody.dart", "Dart", 24, 0, 0, 2, 26
"/Users/yahyajawad/Desktop/Contents/Flutter/baghdad_fair/lib/features/homeBody/statistics/presentation/views/components/calendarFilter.dart", "Dart", 149, 0, 5, 9, 163
"/Users/yahyajawad/Desktop/Contents/Flutter/baghdad_fair/lib/features/homeBody/statistics/presentation/views/components/statisticsCompaniesCount.dart", "Dart", 20, 0, 0, 2, 22
"/Users/yahyajawad/Desktop/Contents/Flutter/baghdad_fair/lib/features/homeBody/statistics/presentation/views/components/statisticsCompaniesCountItem.dart", "Dart", 34, 0, 0, 2, 36
"/Users/yahyajawad/Desktop/Contents/Flutter/baghdad_fair/lib/features/homeBody/statistics/presentation/views/components/statisticsSectionTitle.dart", "Dart", 48, 0, 0, 4, 52
"/Users/yahyajawad/Desktop/Contents/Flutter/baghdad_fair/lib/features/homeBody/statistics/presentation/views/statisticsBody.dart", "Dart", 21, 0, 0, 3, 24
"/Users/yahyajawad/Desktop/Contents/Flutter/baghdad_fair/lib/features/homeBody/videosLibrary/data/models/videosModel.dart", "Dart", 49, 0, 0, 12, 61
"/Users/yahyajawad/Desktop/Contents/Flutter/baghdad_fair/lib/features/homeBody/videosLibrary/data/repository/videosRepo.dart", "Dart", 9, 0, 0, 1, 10
"/Users/yahyajawad/Desktop/Contents/Flutter/baghdad_fair/lib/features/homeBody/videosLibrary/data/repository/videosRepoImpl.dart", "Dart", 26, 0, 0, 4, 30
"/Users/yahyajawad/Desktop/Contents/Flutter/baghdad_fair/lib/features/homeBody/videosLibrary/presentation/manager/videos/videosBloc.dart", "Dart", 26, 0, 0, 1, 27
"/Users/yahyajawad/Desktop/Contents/Flutter/baghdad_fair/lib/features/homeBody/videosLibrary/presentation/manager/videos/videosEvents.dart", "Dart", 7, 0, 0, 1, 8
"/Users/yahyajawad/Desktop/Contents/Flutter/baghdad_fair/lib/features/homeBody/videosLibrary/presentation/manager/videos/videosStates.dart", "Dart", 13, 0, 0, 2, 15
"/Users/yahyajawad/Desktop/Contents/Flutter/baghdad_fair/lib/features/homeBody/videosLibrary/presentation/views/components/videoCard.dart", "Dart", 140, 0, 1, 2, 143
"/Users/yahyajawad/Desktop/Contents/Flutter/baghdad_fair/lib/features/homeBody/videosLibrary/presentation/views/components/videosList.dart", "Dart", 79, 0, 0, 5, 84
"/Users/yahyajawad/Desktop/Contents/Flutter/baghdad_fair/lib/features/homeBody/videosLibrary/presentation/views/videosLibraryBody.dart", "Dart", 30, 0, 0, 2, 32
"/Users/yahyajawad/Desktop/Contents/Flutter/baghdad_fair/lib/features/splash/presentation/views/splashView.dart", "Dart", 13, 0, 0, 3, 16
"/Users/yahyajawad/Desktop/Contents/Flutter/baghdad_fair/lib/features/splash/presentation/views/widgets/splashViewBody.dart", "Dart", 85, 0, 2, 8, 95
"/Users/yahyajawad/Desktop/Contents/Flutter/baghdad_fair/lib/generated/intl/messages_all.dart", "Dart", 48, 0, 10, 10, 68
"/Users/yahyajawad/Desktop/Contents/Flutter/baghdad_fair/lib/generated/intl/messages_ar.dart", "Dart", 105, 0, 10, 7, 122
"/Users/yahyajawad/Desktop/Contents/Flutter/baghdad_fair/lib/generated/intl/messages_en.dart", "Dart", 109, 0, 10, 7, 126
"/Users/yahyajawad/Desktop/Contents/Flutter/baghdad_fair/lib/generated/l10n.dart", "Dart", 681, 0, 86, 93, 860
"/Users/yahyajawad/Desktop/Contents/Flutter/baghdad_fair/lib/l10n/intl_ar.arb", "JSON", 0, 80, 0, 0, 80
"/Users/yahyajawad/Desktop/Contents/Flutter/baghdad_fair/lib/l10n/intl_en.arb", "JSON", 0, 80, 0, 0, 80
"/Users/yahyajawad/Desktop/Contents/Flutter/baghdad_fair/lib/main.dart", "Dart", 46, 0, 1, 3, 50
"Total", "-", 8141, 160, 193, 681, 9175